 # S # # #
 #       #
 #   #   #
 #   #   #
 #   # # #
 #       #
 # # # E #
