 # S # # # # # # # # # # # # # # # # # #
 #                                     #
 #   # # # # # # # # # # # # # # # #   #
 #   # # # # # # # # # # # # # # # #   #
 #   # # # # # # # # # # # # # # # #   #
 #                   #                 #
 # # # # # # # # # # # # # # # # # # E #
