#S##################
#                  #
# ################ #
# ################ #
# ################ #
#         #        #
##################E#
